, , w w w w , ,
, , w . . w , ,
, w w . . w w ,
, w . . . . w ,
w w . . . . w w
w . . . . . . w
w . . . . . . w
w . . . . . . w
w w d w w d w w