w w w w w w w ,
w . w . w . w w
w . . . . . . w
d . . . . . w w
w . . . . . . w
w . w w w . w w
w . w w w . w w
w . . . . . . w
d . . . . . w w
w . . . . . . w
w . w . w . w w
w w w w w w w ,